0000000000000000000000
0000000000000000000000
0000000000000000000000
0000000000000000000000
0000000000000000000000
0000000000000000000000
0000000000000000000000
0000000000000000000000
0000000000000000000000
0000000000000000000000
0000000002222000000000
0000000111111110000000
0000000000000000000000
0000000000000000000000
1111222200000000222222
1111111111111111111111
